SS             SS  S
  S S S  S S  S     
        S   S  SS S 
XXXXX         S     
  S X   S  S      S 
  S XXXXXXXXXXXXX   
  S             X  S
    SS          X S 
         WXXXXXXX S 
   S   S          SS
     S S        S S 
 S   S    SS    S S 
  SSS    S   S      
 S   S          SS  
 S S S  S  S  SS SS 
 S   S         S SS 
 SSSSS     S   S  S 
 SS SS  S      SSSS 
      S    S   S  SS
             S      
		 